
50
#S#####
#.#S#T#
#.#.#.#
#S....#
#####.#