
100
#S#########
#.#S#T#...#
#.#.#.###.#
#.#.#.....#
#.#.#####.#
#.#.#S#.#.#
#.#.#.#.#.#
#.#.#.#...#
#.#.#.###.#
#........S#
#########.#